MAX_STEPS 23
##################
#   # M    D #   #
# 2   MM##DD   1 #
#   # M    D #   #
##################
