MAX_STEPS 23
MAX_FRAMES 220
##################
#   # ^    ^ #   #
# %   *>##<*   1 #
#   # `    ` #   #
##################
