MAX_STEPS 22
MAX_FRAMES 207
##############
#####    #   #
#####      1 #
#####^ aa#   #
#   #*>aa#####
# %      #####
#   #    #####
##############
