MAX_STEPS 29
MAX_FRAMES 300
################
#####      #####
#   #  ^   #   #
# % O  *a    1 #
#   #  `   #   #
#####      #####
################
