MAX_STEPS 19
################
#   #  aa  #   #
# 2    bb    1 #
#   #  cc  #   #
################
