MAX_STEPS 41
MAX_FRAMES 396
###########
####   ####
###     ###
### *>  ###
##  `1^  ##
##   <*  ##
# <*   *> #
#  ` # `  #
#<*>   <*>#
# ` aaa ` #
##### #####
###     ###
#### % ####
####   ####
###########
