MAX_STEPS 41
MAX_FRAMES 396
###########
####   ####
###     ###
### QQ  ###
##  Q1A  ##
##   AA  ##
# ZZ   WW #
#  Z # W  #
#DDD   XXX#
# D aaa X #
##### #####
###     ###
#### 2 ####
####   ####
###########
