MAX_STEPS 231
#################
#+1  #     e    #
#+++ #  M ##### #
#### # dMM  ### #
#    #  M     # #
# aaa#####O  ## #
#             # #
# bc   # # fff# #
# bc     #      #
# bO #OO      # #
#    #OOO  #O # #
######OOOO #O # #
#++++#OO O  g # #
#++++#OOO # g # #
#++++#OOOO# g # #
#+2++#OOOO# g # #
#+     OOO#     #
#################
