MAX_STEPS 195
MAX_FRAMES 1916
#################
#+1  #     e    #
#+++ #  ^ ##### #
#### # d*>  ### #
#    #  `     # #
# aaa#####O  ## #
#             # #
# bc   # # fff# #
# bc     #      #
# bO #OO      # #
#    #OOO  #O # #
######OOOO #O # #
#++++#OO O  g # #
#++++#OOO # g # #
#++++#OOOO# g # #
#+%++#OOOO# g # #
#+     OOO#     #
#################
