MAX_STEPS 104
#############
#  # ObO#   #
#  #  b #   #
#  # ab  #++#
#  #     #  #
#  #OO# e   #
#2  OOOOeff1#
#  #OO# e   #
#  #     #  #
#  # cd  #++#
#  #  d #   #
#  # OdO#   #
#############
