MAX_STEPS 106
MAX_FRAMES 1044
##################
######   ###   ###
#   ##MMM    # Q #
# 1    M #AA #QQQ#
#   ####   A a Q #
######## # ##### #
###### Z # X  ## #
###### ZZ# XX W  #
######     X WWW##
#   ## # ###  W ##
# 2 O     ########
#   ###   ########
##################
