MAX_STEPS 105
MAX_FRAMES 1027
MAX_FRAMES_BIRDS_EYE_VIEW 1011
####################
########    ########
#######     ########
####### a O ########
####### a O      ###
#+   OO a##d       #
#+2 #OOOac deeef 1 #
#++  OO b##d   f   #
####### b O      ###
####### b   ########
####### b   ########
########    ########
####################
