MAX_STEPS 232
MAX_FRAMES 2246
##############
#   ^ ##<*<* #
#  <*>#  ` ` #
#    a#d     #
## ^ a d ## f#
#  *>a#d     #
#  `  #    ^O#
#    #####<*O#
# bb 1#%OO   #
#    ####    #
#  ^  #      #
#  *>c#e     #
#  ` c e g# h#
##   c#e     #
#  <*>#  ^ ^ #
#  O` ##<*<* #
##############
