MAX_STEPS 249
MAX_FRAMES 2623
####################
#+        ++++    +#
#+ +##### #### #+ +#
#+ +#  OOO#O b #+ +#
#+ +#  OO##O cf#+ +#
#+ +#  OOOOO c #+ +#
#+ +#  OOOOO c #+ +#
#+ +#  OOOOO d #+ +#
#+ +#ggO#OOO#e##+ +#
#+ +#   # ij#  #+ +#
#+ +#   # i #  #+ +#
#+ +#  h#  m p #+ +#
#+2+#   # k nq #+1+#
#+++#   #    q #+++#
####################
