MAX_STEPS (118+7)
MAX_FRAMES 1432
###############
#  2 ##########
#    ##########
###  ## e #####
##  ##  e  ####
#OO## fffMM ###
#aaOcc gg M  ##
## bcc  hhii ##
### ccAA j    #
#### dA kk  # #
####  #   p##3#
####  ###np####
#####m###  ####
##### ####  ###
####  ##### ###
#### ###### ###
###4 ####1  ###
###############
