MAX_STEPS 106
MAX_FRAMES 1044
##################
######   ###   ###
#   ##<*>    # ^ #
# 1    ` #<* #<*>#
#   ####   ` a ` #
######## # ##### #
###### ^ # ^  ## #
###### *># *> ^  #
######     ` <*>##
#   ## # ###  ` ##
# % O     ########
#   ###   ########
##################
