MAX_STEPS (130+6)
MAX_FRAMES 1505
###############
#  % ##########
#    ##########
###  ## e #####
##  ##  e  ####
#OO## fff<* ###
#aaOcc gg `  ##
## bcc  hhii ##
### cc*> j    #
#### d` kk  # #
####  #   p##2#
####  ###np####
#####m###  ####
##### ####  ###
####  ##### ###
#### ###### ###
###3 ####1  ###
###############
