MAX_STEPS 22
##############
#####    #   #
#####      1 #
#####M aa#   #
#   #MMaa#####
# 2      #####
#   #    #####
##############
