MAX_STEPS 102
##########
#        #
# 1 aa   #
#        #
##  ###  #
# bbbccc #
#        #
#  ##    #
#  #2OO  #
##########
