MAX_STEPS 180
MAX_FRAMES 1812
####################
#    ########      #
#       aa         #
#    ########      #
############ *>  <*#
#  bbOOOOOOO ` fff`#
#% ccOOOOOOO   fff1#
#  ddOOOOOOO   fff #
#############^    ^#
#    ####### *>  <*#
#       ee         #
#    #######       #
####################
