MAX_STEPS 47
MAX_FRAMES 461
####################
###   *>  ^ ^   ####
###*> ` *>* *<* ####
###`  c ` ^   ` ####
##   dd ^ *>  ^  ###
## aadd<* ` ^ *>m###
## aa e j ^<*  n ###
#%   # ik<*  *>p  1#
## bb f k `<*  q ###
## bbgg<* ^ ` *>r###
##   gg ` *>  `  ###
###^  h ^ `   ^ ####
###*> ^ *>* *<* ####
###   *>  ` `   ####
####################
