MAX_STEPS 300
###############
##########  ###
##1^ a  bbOO###
## Q     # c###
##<E RR#  # ###
##  dR #ghhh###
##e O ff  O ###
##    #    O  #
##OOO   #OO # #
## D iii# #   #
##DDDiii   O###
##    ###MMM###
#  j# #   M ###
#     O # # ###
######### # ###
##2 O   O  O###
###############
