MAX_STEPS 309
MAX_FRAMES 3105
MAX_FRAMES_BIRDS_EYE_VIEW 3049
HAVE_VALIDATOR
####################
#++++++++++++++++++#
#+++############+++#
#+++#####  #####+++#
#+++##  a ^ b1##+++#
#+++## D  G  c##+++#
#+++##DD d  F ##+++#
#+++#  D#<RFF  #+++#
#+++#  ##   eO #+++#
#+++##     ## ##+++#
#+++##O^  # f ##+++#
#+++##OM gO   ##+++#
#+++##O##  #####+++#
#+++##O#########+++#
#+++##O#########+++#
#+2    ++++++++++++#
#++++++++++++++++++#
####################
