MAX_STEPS 217
##################
## #####  ## #+++#
#   b   QQd  O  +#
#   b  cQ d  #+ +#
#   b  c  d  #+ +#
#   b  c  d  #+ +#
#   b  c  d  #+ +#
#  1b 3c 4d 5#+ +#
#   b  c  d  #+ +#
#   b  c  d  #+ +#
#   b  c  d  #+ +#
#   b  c  d  #+ +#
# a bM c  dD #+ +#
#    MMc   DD#+2+#
### #  ####  #+++#
##################
