MAX_STEPS 125
MAX_FRAMES 1212
#################
##      #  aaa ##
#       #       #
#       #O  b#  #
#       #O#cc#  #
#   %     # O# 1#
#       #O  #   #
#       #O    d #
#       # O   d #
##      # eee f##
#################
