MAX_STEPS 300
MAX_FRAMES 3045
###############
##########  ###
##1^ a  bbOO###
## *     # c###
##<* *>#  # ###
##  d` #ghhh###
##e O ff  O ###
##    #    O  #
##<*>   #OO # #
## ^ iii# #   #
##<*>iii   O###
##    ###<*>###
#  j# #   ` ###
#     O # # ###
######### # ###
##% O   O  O###
###############
