MAX_STEPS 309
MAX_FRAMES 3105
HAVE_VALIDATOR
####################
#++++++++++++++++++#
#+++############+++#
#+++#####  #####+++#
#+++##  a ^ b1##+++#
#+++## ^  *  c##+++#
#+++##<* d  ^ ##+++#
#+++#  `#<*<*  #+++#
#+++#  ##   eO #+++#
#+++##     ## ##+++#
#+++##O^  # f ##+++#
#+++##O* gO   ##+++#
#+++##O##  #####+++#
#+++##O#########+++#
#+++##O#########+++#
#+%    ++++++++++++#
#++++++++++++++++++#
####################
