MAX_STEPS (217+24)
MAX_FRAMES 2864
##################
## #####  ## #+++#
#   b   *>d  O  +#
#   b  c` d  #+ +#
#   b  c  d  #+ +#
#   b  c  d  #+ +#
#   b  c  d  #+ +#
#  1b 2c 3d 4#+ +#
#   b  c  d  #+ +#
#   b  c  d  #+ +#
#   b  c  d  #+ +#
#   b  c  d  #+ +#
# a b^ c  d^ #+ +#
#    *>c   *>#+%+#
### #  ####  #+++#
##################
