MAX_STEPS 396
MAX_FRAMES 4061
##################
###Oa cc  ^ ## e1#
###b  cc  *   ffg#
###   dd  ^OO ff #
###<* ###<*h#  *>#
### `  ## ` jjO` #
###<*>    i    m #
### ` # ##O##k m #
###On      OO    #
#### ### ### O # #
###  #O  ###rO OO#
### ppq ###   #  #
##OOppO     O  sO#
#  O##############
#% ###############
##################
