MAX_STEPS 29
################
#####      #####
#   #  M   #   #
# 2 O  Ma    1 #
#   #  M   #   #
#####      #####
################
