MAX_STEPS (34+3)
###############
#   # # # #   #
#   #     # 1 #
#   O  #  a   #
# 2 #     # 3 #
#   # # # #   #
###############
