MAX_STEPS (34+3)
MAX_FRAMES 461
###############
#   # # # #   #
#   #     # 1 #
#   O  #  a   #
# % #     # 2 #
#   # # # #   #
###############
