MAX_STEPS 47
MAX_FRAMES 466
###############
##### ^   #####
#     *<*     #
#    ^`       #
# % <*><*   1 #
#    `^       #
#     *<*     #
##### `   #####
###############
