MAX_STEPS 47
MAX_FRAMES 466
###############
##### Q   #####
#     Q<Y     #
#    FQ       #
# 2 FFF<S   1 #
#    FM       #
#     M<D     #
##### M   #####
###############
