MAX_STEPS 26
###################
#      # a #      #
#      # D #      #
#      MDD c      #
#   2  M   d  1   #
#      MQQ e      #
#      # Q #      #
#      # b #      #
###################
