MAX_STEPS 26
MAX_FRAMES 254
###################
#      # a #      #
#      # ^ #      #
#      ^<* c      #
#   %  *   d  1   #
#      `<* e      #
#      # ` #      #
#      # b #      #
###################
