MAX_STEPS (47+0)
MAX_FRAMES 472
################
#     ^ ^      #
#    <* *>   2 #
#     <* ^     #
#      ` *>    #
# %  <* *>   1 #
#     ` `      #
################
